[
        "2                         2",
        "2                         2",
        "2                         2",
        "2                         2",
        "2                         2",
        "2                         2",
        "2                         2",
        "2                         2",
        "2                    W    2",
        "2                         2",
        "2                         2",
        "2                         2",
        "2    PP   PP   PP         2",
        "2                         2",
        "2                         2",
        "2  F                      2",
        "2PPPPPPPPPPPPPPPPPPPPPPPPP2",
        "222222222222222222222222222",
        "222222222222222222222222222",
        "222222222222222222222222222",
        "222222222222222222222222222",
        "222222222222222222222222222"]