[
        "2                           2",
        "2                           2",
        "2                           2",
        "2                           2",
        "2                           2",
        "2                           2",
        "2                           2",
        "2                           2",
        "2                    W      2",
        "2                           2",
        "2                           2",
        "2    PP   PP                2",
        "2                           2",
        "2                           2",
        "2                           2",
        "2  F                       E2",
        "2PPPPPPPPPPPPPPPPPPPPPPPPPPP2",
        "22222222222222222222222222222",
        "22222222222222222222222222222",
        "22222222222222222222222222222",
        "22222222222222222222222222222",
        "22222222222222222222222222222"]
